1111111111111111
4444444444444444
4444444444444444
1111111111111111
1000000000000001
1000000000000001
1000000000001001
1000000000001001
1000000000001001
1000000000001000
1000000000001000
1111111001111111
5
3
173
