1111111771111111
1777461775555551
1777461111111171
1777444444444471
1777777777777111
1777777777777160
1777777777777160
1777777777777161
1511111111111161
1555555555555161
1000000000000001
1661111001111111
9
12
170
