1999999009999991
1000000000000001
1222222222222221
1000000000000001
1000000000000001
1000000000000000
1000000000000000
1000000000000001
1000000000000001
1000000000000001
1000000000000001
1111111991111111
120
70
240