1111111661111111
1000000660000001
1000000660000001
1000000660000001
1000000000000001
1000000000000001
1000000000000001
1000000000000001
1000000000000001
1000000000000001
1000000000000001
1111116111111111
22
21
108
