1111111111111111
1444444444444441
1444444444444441
1444444444444441
1444444444444441
4444444444444441
4444444444444441
1444444444444441
1444444444444441
1444444444444441
1000000000000001
1111111001199991
66
82
167
