1111111111111111
4444444444444444
4444444444444444
1111116666111111
1111116666111111
1111116666111111
1111116666111111
1111116666111111
1111116666111111
1111116666111111
1111116666111111
1111116666111111
69
69
160
