1111111001111111
1000000000444461
1010000000444461
1010000000444461
1011111111111101
1000000000000004
1001111171111004
1001111171111101
1000000000000001
1000000000000001
1000000000000001
1111111111111111
38
36
209
