1991111001111911
1660006000000001
1660004011111001
1661000000001771
1661000000001771
1661000000001771
1661000000001771
1661000000001771
1661111111111771
9444444444444779
9444444444444771
1191111111111991
0
0
255
