1111111111111111
1007201222220001
1007161777770001
1107161777770001
1617161777770001
0617161777770001
0617160777777729
1617160777777721
1617120000000001
1617111111111101
1607000000000001
1111111001111191
59
58
165
