1111111111111111
1000000001444444
1000000001444444
1000000001000001
1096000005000041
1000000005000041
1000000001000001
1000000001000001
1000000001000001
1000000000000001
1000500001000001
1111111111111111
0
0
165
