1111111111111111
1000000000000001
1000000000000001
1000000000000601
1117474711000601
0024447400000900
0011474701110000
1110000000010001
1000000000010001
1000000000000001
1000000000000001
1111111111111111
77
77
129
