1111110111111119
0055094444444449
0055094444444449
1591444444444449
1590499999999999
1590200000000000
1592222222000000
1590000002220029
1590000000000029
1599999999000209
1555555559002009
1111111779999999
46
148
175
