1111111111111111
4444444444444461
4444444444444461
1111111111111661
1655555555555551
1611111111111111
1444444444444461
1111111111111161
1155555555555551
0000111111111121
0000555555555551
1111111111111191
100
100
255
