1009111001111111
1007777777777771
1000000000000071
1000000000000071
1600000000000041
4466666000000041
4444466666666641
1444444444444441
1777777977777771
1000000000000001
1000000000000001
1119111001111111
63
215
222
