9999999009999999
9999999669999999
9999999669999999
9999999669999999
9999999669999999
0000004665000009
0000004665000009
9299999669999929
9299999669999929
9099999669999909
9000000220000009
9999999229999999
95
25
209
